10,10
120

WWWWWWWWWW
WQFFFMOOOW
WPPPPPDPPW
WPPPPPWOOW
WPPPPPPPDW
WWTWWPPPDW
WPPPWWWYWW
WPEPWPPPPW
WPPPWPCPPW
WWWWWWWWWW

----------
----------
--*-------
----------
----------
----------
----------
----------
--%-------
----------

----------
----------
--------y-
----------
----------
----------
----------
----------
----------
----------

(2,2) @ S
(8,2) @ E
(6,8) -> (2,5)