10,10
80

WWWWWWWWWW
WOOOWPPEPW
WPPPPPPPPW
OFFFFFFFFO
WPPPPPPPPW
WRWWWWWWWW
OFFFFFFFFO
FFFFFFFFMO
WPPPWPPPPW
WWWWWWWWWW

----------
----------
----------
----------
--------@-
----------
----------
----------
--*-------
----------

----------
----------
----------
----------
----------
----------
----------
----------
-------r--
----------

(2,8) @ S
(8,4) @ E
(1,3) _
(6,6) _
(0,7) _