10,10
120

WWWWWWWWWW
WOOOWPPEPW
WPPPPPPPPW
OQFFFFFFFO
WPPPPPPPPW
WRWWWWWWWW
OFFFFFQFFO
QFFFFFFFMO
WPPPWPPPPW
WWWWWWWWWW

----------
----------
----------
----------
--------@-
----------
----------
----------
--*-------
----------

----------
----------
----------
----------
----------
----------
----------
----------
-------r--
----------

(2,8) @ S
(8,4) @ E