10, 10
120

WWWWWWWWWW
WPPPPPPPPW
WPPPPPPPPW
WPPPPPPPPW
WPPPPPPPPW
WPPPPPPPPW
WPPPPPPPPW
WPPPPPPPPW
WPPPPPPPEW
WWWWWWWWWW

----------
----------
--*-------
----------
----------
----------
-------@--
----------
--$-------
----------

----------
----------
------+---
----]-----
-------x--
------v---
----c-----
----------
----------
----------

(2,2) @ S
(8,2) @ E
(6,8) -> (2,5)
