10,10
300

WWWWWWWWWW
WPPPPPPPPW
WPPPPPPPPW
WPPPPPPPPW
WOOOOOOOOW
WPPPPPPPPW
WPPPPPPPPW
WPCPPPPWWW
WPPPPPPTEW
WWWWWWWWWW

----------
-*--------
--#-------
----------
----------
----------
--#-------
----------
----------
----------

----------
----------
----------
----------
----------
----------
----------
----------
----------
----------

(1,1) @ S
(2,7) -> (7,8)