8,7
12

WWMWEPPP
PPAWPPPP
PPAWWPPP
PPNWOOOP
WWAWPAAO
PPAWWAAW
PPPPPNNW

--------
*#----%-
--------
--------
--------
--------
-#------

--------
--------
--------
--------
--------
--------
--------

(1,1) @ E