12,8
180

WWWWWWWWWWWW
WUIIPPPPPPEW
WIPPPPPPUJPW
WIPPPPPPIIPW
WIPPPPPPKIIW
WKJPPPPPILPW
WPPPPPPPPPPW
WWWWWWWWWWWW

------------
------------
-----#------
------------
------------
------------
-*----------
------------

------------
------------
------------
------------
------------
------------
------------
------------