9,9
15

WWWWWWWWW
WPPPPPPPW
WPPPPPPPW
WPPPPPPPW
WPPPPPPPW
WPPPPPPPW
WPPPPWPPW
WPPPPPPPW
WWEWWWWWW

---------
--*------
----#----
---------
---------
---------
-;-----;-
---------
---------

---------
---------
---------
---------
---------
---------
---------
---------
---------

(2,1) @ S