10,10
25
0

OOOOOOPPWW
OFFFHOOPPW
OWWOHOOOPP
HMMMMMMMMM
HOOOOOOOOA
HOPPPPPPOA
HOOOOOPOOA
FFFFFFFFFA
WWWWWWPWWW
WWWEYPPWWW

----------
-*--------
----------
----------
----------
----------
----------
----------
----------
----------

----------
----------
----------
----------
----------
---y------
----------
----------
----------
----------

(1,1) @ N
(1,1) _