8,9
180

WWWWWWWW
WPPPPPPW
WPPPPPPW
WPDDPPPW
WWWWWRWW
WOOPPPPW
WOPPPPPW
WPEPPPPW
WWWWWWWW

--------
-*------
--------
--------
--------
--------
-----@--
--------
--------

--------
--------
--------
-rb-----
--------
--------
--------
--------
--------

(1,1) @ E
(5,6) @ W