10, 10
120

WWWWWWWWWW
WPPPPVPPPW
WPPPPPSPPW
WPPPP]PPPW
WPPPPP+PPW
WPPPPXPPPW
WPPPPPPPPW
WPPPPPPPPW
WPPPPPPPPW
WWWWWWWWWW

----------
----------
--*-------
----------
----------
----------
-------@--
----------
--$-------
----------

----------
----------
----------
----------
----------
----------
----------
----------
----------
----------

(2,2) @ S
(8,2) @ E
(6,8) -> (2,5)