14,8
300

CPCOWWWWWWWWWW
PWPOWPWPWPWPWE
CPCOWTWTWTWTWR
OOOOWPPPPPPPWG
WPPPPPPPPPPPWB
WPPPPPPPPPPPWY
WPPPPPPPPPPPPP
WWWWWWWWWWWWWW

$-------------
--------------
--------------
--------------
-----------*--
--------------
-------------@
--------------

--------------
-----r-g-b-y--
--------------
--------------
--------------
--------------
--------------
--------------

(0,0) @ E
(11,4) @ W
(13,6) @ W
(0,0) -> (5,2)
(2,0) -> (7,2)
(2,2) -> (9,2)
(0,2) -> (11,2)