8,7
12
0

WWMWEPPP
PPAWPPPP
PPAWWPPP
PPAWOOOP
WWAWPAAO
PPAWWAAW
PPPPPAAW

--------
*#----%-
--------
--------
--------
--------
-#------

--------
--------
--------
--------
--------
--------
--------

(1,1) @ E
(2,3) _
(5,6) _
(6,6) _