32,32
300

WWWWWWWWWWWWWWWWWWWWWWWWWWWWWWWW
WPPPPPPPPPPPPPPGPPPPPPPPPPPPPPPW
WPPPWOPPPPPPPPPWPPPWPPPPPPPPPPPW
WPDPWOPPPPPPPPPWPPPWPPPPPPPPPPPW
WPDPWOPPPPPPPPPWPPPWPPPPPPPPWPPW
WDPPWOPPPCPPPPPWPPPWPPPPPPPPWPPW
WDPPWOPPPPPPPOOWPPPWPPPPPPPPWPPW
WPPPWOPPPCPPPOOWPPPWPPPPPPPPWPPW
WPDPWOPPDDPPPPPWPPPWPPPPPPPPWPPW
WPDDWODDDDDDPPPWPPPWPPPPPPPPWPPW
WPOPWOPPDDDDPPPWPPPWPPPPPPPPWPPW
WPDPWOPPPPPPPPPWPPPWPPPPPPPPWPPW
WPOOWOPPPPPPPPPWPPPWPPPPPPPPWPPW
WPPPPPPPPTPPPPPWPPPPPPPPPPPPPPPW
WWWWWWWWWBWWWWWWWWWWWWWWWWWWWWWW
WPPPPPPPPPPPPPPWPPPPPPPPPPPPPPPW
WPPPWPPPPPPPWPPWPPPWPPPPPPPPPPPW
WPPPWPOPPPOPWPPWPPPWPPPPPPPPPPPW
WPPPWPPPPPPPWPPWPPPWPPPPPPPPPPPW
WPPPWPPPPPPPWOOWPPPWPPPPPPPPPPPW
WPPPWPPPPPPPWOOWPPPWPPPPPPPPPPPW
WPPPWPPPPPPPWPPYPPPWPPPPPPPPPPPW
WPPPWPPPPPPPWPPWPPPWPPPPPPPPPPPW
WPPPWPPPPPPPWPPWPPPWPPPPPPPPPPPW
WPPPWPPPPPPPWPPWPPPWPPPPPPPPPPPW
WPPPWPPPPPPPWPPWPPPWPPPPPPPPPPPW
WPPPWPPPPPPPWPPWPPPWPPPPPPPPPDDW
WPPPWPPPPPPPWPPWPPPWRWWWWWWWWWOW
WPPPWPPPPPPPWPPWPPPWPPPPPPPPPDDW
WPPPWPPPPPPPWPPWPPPWPPPPPPPPEPPW
WOOOOPPPPPPPPPPWPPOOOOPPPPPPPPPW
WWWWWWWWWWWWWWWWWWWWWWWWWWWWWWWW

--------------------------------
--------------------------------
--------------------------------
----------------------------*---
--------------------------------
--------------------------------
--------------------------------
---------^----------------------
--------------------------------
--------------------------------
--------------------------------
--------------------------------
--------------------------------
--------------------------------
--------------------------------
--------------------------------
--------------------------------
-----%-----$--------------------
--------------------------------
--------------------------------
--------------------------------
-----@--------------------------
--------------------------------
-----@--------------------------
-----------@--------------------
--------------------------------
-----------@--------------------
-----@--------------------------
-----------@--------------------
--------------------------------
--------------------------------
--------------------------------

--------------------------------
--------------------------------
--------------------------------
--------------------------------
--------------------------------
--------------------------------
--------------------------------
--------b-----------------------
--------------------------------
--------------------------------
--------------------------------
--------------------------------
-----------------------g--------
--------------------------------
--------------------------------
--------------------------------
--------------------------------
--------------------------------
--------------------------------
--------------------------------
--------------------------------
--------------------------------
--------------------------------
--------------------------------
--------------------------------
--------------------------------
--------------------------------
--------------------------------
-----------------r--------------
--------y-----------------------
--------------------------------
--------------------------------

(28,3) @ W
(5,21) @ E
(5,23) @ E
(11,24) @ W
(11,26) @ W
(5,27) @ E
(11,28) @ W
(9,5) -> (9,13)
(9,7) -> (9,13)